NO ./textures/colorstone.xpm
SO ./textures/barrel.xpm
WE ./textures/colorstone.xpm
EA ./textures/gate_1.xpm

C 225,30,5
F 220,100,0


111111111111111111111111
100000000000000000000001
100000000000000000000001
100000000000000000000001
100000666660000303030001
100000600060000300030001
100000600060000000000001
100000600060000000000001
100000660660000303030001
100000000000000000000001
100000000000000000000001
100000000000000000000001
100000000000000000000001
100000000000000000000001
100000000000000000000001
100000000000000000000001
144444444000N00000000001
140400004000000000000001
140000504000000000000001
140400004000000000000001
140444444000000000000001
140000000000000000000001
144444444000000000000001
111111111111111111111111
