NO ./path_to_the_north_texture
SO ./path_to_the_south_texture
WE ./path_to_the_west_texture
EA ./path_to_the_east_texture

C 225,30,5
F 220,100,0

111111111111111111111111
100000000000000000000001
100000000000000000000001
100000000000000000000001
100000666660000303030001
100000600060000300030001
100000600060000000000001
100000600N60000000000001
100000660660000303030001
100000000000000000000001
100000000000000000000001
100000000000000000000001
100000000000000000000001
100000000000000000000001
100000000000000000000001
100000000000000000000001
144444444000000000000001
140400004000000000000001
140000504000000000000001
140400004000000000000001
140444444000000000000001
14000000000S000000000001
144444444000000000000001
111111111111111111111111
