NO ./assets/Wall-0161647953497.xpm
SO ./assets/Wall-0281647953497.xpm
WE ./assets/Wall-0321647953497.xpm
EA ./assets/Wall-0661647953498.xpm

C 102,255,255
F 255,100,100


111111111111111111111111
100000000000000000000001
100000000000000000000001
100000000000000000000001
100000111110000101010001
100000100010000100010001
100000100010000000000001
100000100010000000000001
100000110110000101010001
100000000000000000000001
100000000000000000000001
100000000000000000000001
100000000000000000000001
100000000000000000000001
100000000000000000000001
100000000000000000000001
111111111000N00000000001
110100001000000000000001
110000101000000000000001
110100001000000000000001
110111111000000000000001
110000000000000000000001
111111111000000000000001
111111111111111111111111
